========================================
=______1_______==___4____==______1_____=
=_______________=________=_____________=
=_____1_____2___=________=_____2____1__=
=_______________=0______0=_____________=
=_______________===____===_____________=
=___0____________0______0__________0___=
=______________________________________=
=______________________________________=
=____2_____0_____0_____0____0______2___=
=______________________________________=
=______1_________________________1_____=
=______________________________________=
=___1_______2_______________2____1_____=
=______________________________________=
=__===========0__________0===========__=
=__________1_=____________=______1_____=
=__________1_=____________=______1_____=
=____________=0__________0=____________=
=1((_________=____________=__((_______1=
=1___________=____________=___________1=
==============0__________0==============
333.......cba.............ghi.........S.
3333......fed.............jlk...........