&&&...................................&&
&&...................................&&&
&...................................&&&&
...............|........................
.............|.|........................
............||||........................
.................R......................
.............^^.........................
............^@@^........................
............^@@^........................
.............^^..............&..........
.............S..........^^^^&&&&........
................V......^&&&&&&&.........
........................^&&&.&..........
...........V.............^&&............
.........V....................@......@..
........................................
............^^..........................
..........&&&&&&................$%%.....
............&&&^................%%%.....
.............^&&................%G%.....
........................................
........................................
..............................@......@..