----------------------------------------
--------------55.565...55---------------
-----------------00.00------------------
-------1111|||................111-------
------.....|^|||..................------
------.....|^|||...........|....2.------
------.....|^|............|^|...2.------
------.....|^|...........|^3^|....------
------..1..|||..........|^3&3^|...------
------.....5.5.........|^3&&&3^|..------
------.22.....00000....5|^3&3^|5..------
------........00000.....5V^3^|5...------
------....................|^|.....------
------...............0.....|......------
------..1...........050....5......------
------...............0............------
------.1...|.................1.111------
------....^^4.....................------
------....|414....................------
------.2..||4............11.....2.------
-------2...............4411.....2-------
--------------.hijkl...44---------------
-----------------cdefg------------------
-------------------ab-------------------