----------------------------------------
--------------....T......---------------
-----------------.....------------------
-------....|||...................-------
------.....|^|||..................------
------.....|^|||...........|......------
------.....|^|............|^|.....------
------.....|^|...........|^&^|....------
------.....|||..........|^&&&^|...------
------.................|^&&&&&^|..------
------........@@@@@.....|^&&&^|...------
------........@@@@@......V^&^|....------
------....................|^|.....------
------.....................|......------
------............................------
------............................------
------.....|......................------
------....^^^.....................------
------....|^|.....................------
------....||^.....................------
-------................^|SR......-------
--------------.........|^---------------
-----------------.....------------------
-------------------..-------------------