abc.............&&&&&&..................
def...............&&&&&.................
..................&&&&&.................
sr.......11......&&&&...................
.........122.......&&&..................
..................&&&...................
...................&....................
..............3.........................
...........&.....&.&.&..................
..........&&.....&&&&&..................
.........&&&&&..&&&&&&&.................
.........&&&....&&&&&&&.................
........&&.....&&&&&&&&&................
..............&&.&&&...&&...............
..............&&...&..&&................
................&&..&.&&................
...................&....................
......................&&&...............
....................&&&&................
..................&&&.&.................
....................&.&&.&&.............
...................&&&&..&&&............
...............&&&.&&&&..&&&............
.............&&&..&&&&&&&&&.............