abcefd..|.......&&&&&&..................
^^^^^^^.|.........&&&&&.................
||||^^^^|.........&&&&&.................
SRV|^.^.^11......&&&&...................
||||^^^^^122.......&&&..................
^^^^^.^...........&&&...................
...................&....................
..11....................................
..2..1.....&.....&.&.&..................
..........&&.....&&&&&..................
...2.....&&&&&..&&&&&&&.................
...2.....&&&....&&&&&&&.................
...2....&&.....&&&&&&&&&................
..............&&.&&&...&&...............
..............&&...&..&&................
................&&..&.&&................
...................&....................
......................&&&...............
....................&&&&................
..................&&&.&.................
.................3..&.&&.&&.............
...................&&&&..&&&............
...............&&&.&&&&..&&&............
.............&&&..&&&&&&&&&.............