========================================
=______________==___T___==_____________=
=_______________=_______=______________=
=_______________=_______=______________=
=_______________=_______=______________=
=_______________===___===______________=
=______________________________________=
=______________________________________=
=______________________________________=
=______________________________________=
=______________________________________=
=______________________________________=
=______________________________________=
=______________________________________=
=______________________________________=
=__===========____________===========__=
=____________=____________=____________=
=____________=____________=____________=
=____________=____________=____________=
=_((_________=____________=__((________=
=____________=____________=____________=
==============____________==============
...................................SR...
........................................