&&&...................................&&
&&...................................&&&
&...................................&&&&
...............|........................
.............|.|........................
............||||........................
.................r......................
........................................
........................................
........................................
.............................&..........
.............s..........^^^^&&&&........
................v......^&&&&&&&.........
........................^&&&.&..........
...........v.............^&&............
.........v..............................
........................................
............^^..........................
..........&&&&&&........................
............&&&^........................
.............^&&........................
........................................
........................................
........................................