&&&..............................1....&&
&&.................11......2.........&&&
&.....3...........1..1..............&&&&
.............|||........................
........i...f|^|................1.......
2......hg...e|||....3......1............
..........abcd2..R..............1.......
........3..^^kj..............2..........
...1......^@@^......2...................
..........^@@^..........................
...........^^................&44.44.4.44
..2..2.......S..........^^^^&&&&........
...2............V......^&&&&&&&.44.4.44.
........................4&&&.&..........
...........V.............^&&............
....2....V............4.......4......4..
.....................4..................
............^4.................44444....
..........&&&&&&...4....4......4$%%4....
............&&&^..4.....4......4%%%4....
.............^&&...4...4...4...4%5%4...4
........................4......44444....
...............4........4...............
...1...1......................4......4..