&&&...................................&&
&&................2222...............&&&
&.................1111..............&&&&
........................................
........i...f...........................
.......hg...e...........................
..........abcd...r......................
.............kj.........................
........................................
........................................
.............................&..........
..1111.......s..............&&&&........
..2222..........v.......&&&&&&&.........
.........................&&&.&..........
...........v..............&&............
.........v..............................
........................................
........................................
..........&&&&&&........................
............&&&.........................
..............&&........................
........................................
........................................
........................................