----------------------------------------
--------------.555565555.---------------
-----------------44.44------------------
-------....||4..---..---.........-------
------....||^4544...45554.........------
------....||^|44.....454...|......------
------....||^|........4...|^|.....------
------.....|^|...........|^3^|....------
------.....|||..........|^&&3^|...------
------.................|^&&&&3^|..------
------.......444444.....|^333^|...------
------.......444444......|^3^|....------
------.11.................|^|.....------
------.22.........55.......|......------
------....^1^.........a...........------
------....^1^........ebcd......2..------
------...^^1^12.....fghijkl.......------
------...^^|212....0..........22..------
------....|^|1|....00.2...2...2...------
------....||^1|...................------
-------......12........^|........-------
--------------2........|^---------------
-----------------.2.2.------------------
-------------------..-------------------