.......|........&&&&&&..................
^^^^^^.|..........&&&&&.................
||||^^^|..........&&&&&.................
srv|^.^.^........&&&&...................
||||^^^^^..........&&&..................
^^^^^.^...........&&&...................
...................&....................
........................................
...........&.....&.&.&..................
..........&&.....&&&&&..................
.........&&&&&..&&&&&&&.................
.........&&&....&&&&&&&.................
........&&.....&&&&&&&&&................
..............&&.&&&...&&...............
..............&&...&..&&................
................&&..&.&&................
...................&....................
......................&&&...............
....................&&&&................
..................&&&.&.................
....................&.&&.&&.............
...................&&&&..&&&............
...............&&&.&&&&..&&&............
.............&&&..&&&&&&&&&.............