========================================
=______1_______==2_565_2==_______1_____=
=_______________=4_____4=______________=
=_____1_____2___=4_____4=______2____1__=
=_______________=2_____2=______________=
=_______________===___===______________=
=___0___________42_____24__________0___=
=______________________________________=
=______________________________________=
=____2_____0_____0_____0____0______2___=
=______________________________________=
=______1_________________________1_____=
=______________________________________=
=___1_______2_______________2____1_____=
=______________________________________=
=2_===========0__________0===========_2=
=__________1_=____________=______1_____=
=__________1_=____________=______1_____=
=____________=0__________0=____________=
=1((_________=____________=__((_______1=
=1___________=____________=___________1=
==============0__________0==============
333.......cba.............ghi......SR...
3333......fed.............jlk...........