----------------------------------------
--------------...55655...---------------
-----------------55555------------------
-------....|4|..---44---.........-------
------....|454||..................------
------....|454||..4........|......------
------....|454...454......|^|.....------
------.....454....4......|^&^|....------
------.....|4|..........|^&&&^|...------
------.................|^33333^|..------
------00000..444444.....|^333^|...------
------.......444444......|^3^|....------
------........2....2......|^|.....------
------.......2.............|....2.------
------.1..^^^....11...............------
------....^|^.......abcdek.1...2..------
------..2^^|^^..1...fghijl........------
------...^^^^2................11..------
------....|^|22...2....2......11..------
------....||^22...................------
-------..............2.^|....1...-------
--------------..2......|^---------------
-----------------.....------------------
-------------------..-------------------