----------------------------------------
--------------.....T.....---------------
-----------------.....------------------
-------....|||..---..---.........-------
------....||^|||..................------
------....||^|||...........|......------
------....||^|............|^|.....------
------.....|^|...........|^&^|....------
------.....|||..........|^&&&^|...------
------.................|^&&&&&^|..------
------.......@@@@@@.....|^&&&^|...------
------.......@@@@@@......|^&^|....------
------....................|^|.....------
------.....................|......------
------....^^^.....................------
------....^|^.....................------
------...^^|^^....................------
------...^^^^|................^^..------
------....|^|||...............^^..------
------....||^||...................------
-------................^|........-------
--------------.........|^---------------
-----------------.....------------------
-------------------..-------------------