========================================
=______________==___T____==____________=
=_______________=________=_____________=
=_______________=________=_____________=
=_______________=________=_____________=
=_______________===____===_____________=
=______________________________________=
=______________________________________=
=______________________________________=
=______________________________________=
=______________________________________=
=______________________________________=
=______________________________________=
=______________________________________=
=______________________________________=
=__===========____________===========__=
=____________=____________=____________=
=____________=____________=____________=
=____________=____________=____________=
=_(__________=____________=__((________=
=____________=____________=____________=
==============____________==============
......................................S.
........................(...............